10 10 3
1122212122
1112112211
1312212122
2211212222
1211212221
2111111111
1111211111
1211111222
1211111212
2220121212
